name	decision	sequence
Brian Chase (Wikipedia hoaxer)	K	KKDDKKDKKKKDKKKKKKKKKKKKKKKKKKDKKKKKDKKKKKKKKKKKKKKKKKKKKKKKKKDDDKKKKKKKKKKDKKKDKKDKKKKKKKKKKKKKDKKKKKKKKKKKKKKKKKKKKKKKKKKKKDKKKKKKKDKKDKKKKKKKKKKKKKKKKKKKDKKKKKKDDDKKKKDKKKDKDKKKKKDKKKDDKKKKKKDKKDKDKKDKKKKKKKKKKKKKKKKKKKKKKDKKDKKDKDKKKKKKDDDDKKKKKKKKKKKKKKKKKKKKKKKKKKKKKK
Essjay	K	DDDKDDDDKDDDDDKKKKDKKKKDDDDDDDDDDDDDKKDDKDDDDDDKDKDKDDDKKDKKKKDKDKKDKDKDDKKKDDDDKDDKDKKKKKKKKDDKDKDKDKKDDKKDKDDDDKKKKKKDDDKKKKKDDKDKDDDKDDKDKKKDKKKKKKKKKKKKKKKKKKKKKKKKKKKKKKKKKKKKKKKKKKKKKKKDKKKKKKK
Angela Beesley (3rd nomination)	K	DDDDDDDDDDDDDDKKKKDDDDDDDKKDDKKKKKDDDDKKKKDKDKKKKDKKKDKDKDKDDKDKKDDDDKKKDDKKKKDDKDDKKKDKDKKDKDKDKKDKDKDKDDK
Religious persecution by Jews	K	DKDDDDKDDDDDDKKKKKDDDDDKDKKDDDDDDKDKDDKDDKKKDKDKDDDKKDKDDKDKDKDKDKKKDDDDDKKDDDDDDDDDDDKKKK
Cyrus Farivar	K	DKKKKDDDKDDDDDDDDDKKDDDKDDKKKKKDDDDKDDDDKKDDKKDDDDKKDDDDDDDKDDDDDDDDDDDDDDDKKKKKKKKKK
Human disguise	K	DDKDKDKKKDKDKDKDKDDDDDDDKDKKDKDKDDKKKDKDKKDDDKDDDDDKKKDKK
Jamie Kane	K	KDDKDKDDDDDDDDDDDDDDKDDDDDKDDKDKKKKKKDDDKKKKKKKKKDKKKKKKDKKKKDDKKDDKKKKKKKDKKKKKKKKKKKKKKKDDKKDDKKKDKKKKDDDDDDDDDDDDDDDDDDDDDDDDDDDDKKKKKKKKKKKKKKKKKKKKKKKKKKKK
Rationales to impeach George W. Bush (3rd nomination)	K	DKKDDKDDKDKKDKKKDDDDKDDDDDKKKDDDDDDDKDKKKDDDDDDKDDKDKKDDKDDDDKKKDDKDDDDDDDKDDDDKKKDKDDKKDDDKKDDDDDDKKDDDDKKKDKKDKKDDKKKKDKDDDKKDKDDKKKDDDDDKKDDKDDD
Encyclopedia Dramatica (2nd nomination)	K	KDKKKKKDKKDDKDKDKKKKKKKKKKKKKKDKKKKKKKDKDDKKKDKDKKDKKKDKKKKDKDKKKKKDKKKDKDKDKDKDKKKKKKKKKKKKKKKKDDKKDKKKKKDKKKKKDKKKKKKKKDKKDKKKKKKKKKKKDDDDKKKKK
Solar eclipse on 2006 March 29	K	KKKDDKKKKKKKKKKKKKKKKKKKKKKKKKKDKKKKKKKKKKKKKKKKKKKKKKKKKKKKKKKKKKKKKKKKKKKKKKKKKKKKKKKKKKKKKKKKKKKKKKKKKKKKKDKKKKKKKKKKKKKKKKKKKKKDKKKKKKKKK
Colorado balloon incident	K	DKKKKKKKKKKDDKKKDDKDDDDKDKDKKDKDDKDDDDKDKDDDDDKKDKKKDDDKDDDDKKDDKDDKDDDKKDDKKKKKDDDKKDKDDKDDKKDDDDKDDKDKDDKDKKDKKKDDKDDDKKDDDKKKKDKKKKKKDKKKK
Flying Spaghetti Monster	K	DKKKKKKKKKKKKKKKKKKDKKKKKKKKKKKKKKKKKKKKKKKKKKKKKKKKKKKKKKKKKKKKKKDKKKKKKKKKKKKKKKKKKKKKKKKKKKKKKKKKKKKKKKKKKKKKKKKKKKKKKKKKKKKKKKKKKKKKKK
Gay Nigger Association of America (6th nomination)	K	DKDKDDKKDDDDDKKKKKDDDKKDKDKKDDDDDDDDDDDDDDDDDDDDDDDDDDDDDDDDDDDDDDDDDKKKKKKKKKKKKKKKKKKKKKKKKKKKKKKKKKKKKKKKKKKKKKKKKKKKKKK
What Really Happened	K	DDKDKDDKDKKKDKKKKKDKKDDDKDDKKKKKKKKKKKKKKKKKKDDKDKKKKKDKKKDKKKDKKKKKKKKKKKKKKKKKKKKKKKKKKKKKKKKKKKKKKKKKKKKKKKKKKKKKK
Susan Boyle	K	DDDKKKKKKKKKKKKKKKKKKKDKKKKKKKDKKKKKKKKKKKKKDKKKKKKKDKKDDKKKDKKKKKKKKKKKKKKKKKKKKKKKKKKKKKKKKKDKKKKDKKKKDKDKKDKKKKKKK
Wikitruth	K	DDKDDKKDKKKDKDKKKKKDKKKKDDKDKDKKKDKKKKKDKKDKKKKKDDKKKKKKKKKKKKKDKKKKKKKKKDKKKDKKKKKKKKKKKKDKKDKKDKKDKKKKKKKKKKKKKKKK
Ric Romero	K	KDKKDDDKDKDDKDDKKKKDDDKDKDDDKKDKKKKKKKKDKKKKKKKKKKKKKKKKKKKKKKKKKKKKDKKKKKKKKKKKKDKKKKKKDKKKKDKKKKKKKKKKKKKKKKKKKK
Nidal Malik Hasan	K	DKDKKKDDDKKKKDKKKDKDKKDDKKDKKKKDDDKDKKKKDKKKKDKKKKKKDKKKDDKKKDKKKKKKKKKKKKKKKKKKKKKKKKDKKKKKKKKKKKKKKKKKKKDKKKK
List of shock sites (fourth nomination)	K	DDDDDKDDKDKKKKKDKKDDDDDKKKDDKKKKKKKKKKKKKKKDDDDKDDKKKDKKKKDDKKKKDDDKDKKKKKDKKKDKKKDKKKDKKKDKKKDKKDKKKKKKKK
Republic of Ireland vs France (2010 FIFA World Cup Play-Off)	K	DDDDDDDDDDDKKDKKKKKKDKKKKDKKKKKKDKKKDDKKKDDKKDDKDKDKKDKKDKDKKKKDKKKKKKKKKKKDKKDKKKKDKKKKKKKKKDKKDDDDKK
King Kong defence	K	DKDKKKKKKKKKDDKKKKKKKKKKKKKKKKKKKKKKKDKKKKKKKKKKKKKKKKKKKKKKKKKDKKKKKDKKKKKKKKKKKKKKKKKKKKKKKKKKKKKKK
Israeli apartheid (phrase)	K	DKDDDKDDKDDKDKDKDDDDDDDDKKKDDKKDKDDDDDDDKDKDDKKKKDKKKKKKDDKKDKKKKKDKDDKDDKDKDDKKKKKKKDKDDDKDDDDDDKKK
State terrorism by the United States (sixth nomination)	K	DKDKDKDDDKKKDDKKKKKKDKKKDKDDDKKKDDDDKDDDKDKDDKDDDDKDKKKKKDDKKKKDDKKKKKKDKKKKDKDKDDKDDDDDKDKKDKDDKKKK
Giovanni di Stefano	K	KKDDDDKDDKKKKKKKKKDKKKKKKKKKKKKKKKKKKKDKKKKKKKKKKKKKKKKKKKKKKKKKDKKKKKKKKKKKKKKKKKKKKKKKDDKKKK
Project Chanology	K	DKKKKDKKKKKKKKKKDKKKKKKKKKKKKKKKDKKKDKKKKKKKKKKDDKKDDKKKKKKKKKKKKKKKKKKKKKKKKKKKKKKKDKKKKKKKK
Qantas Flight 30	K	DDDDDDDDKKKDKKKKKKKKKKKKKKDKKKKKDDKDDKDKKKKKKKKKKKKKKKKKKKKKDDKKKKKKDKKKDDKKKKKDKKKKKDK
Joseph Wurzelbacher	K	DKKDKKKKDKKDKKKKKKKKDKKKKKKKDKKKKKKKDDKKKKKKKDKKKKKKKKKDKKDKKKDKKKKKDKKKKKKKKKDKKKKDKK
Michaele Salahi	K	DDDDKKKDKDDKDKKKKKDDKKDDKKKDKDKKKKDKKKDDDDKKDKKKKDKKKDKDKKKKKDDKDKKKDKKKDKDKKKKK
A More Perfect Union	K	DDKKKKKKKKDKKDKKDDKDKDKKKKKDKKKKDKKKKKKDKKKKKKKKKKKKKKDKKKKKKKKDKKKKKKKKKDKKKKK
Alleged causes of Hurricane Katrina	K	DDDDDKDKKKKDKDDKDDKKDDDDKKKDDDDKKDKDKDDDKKDKDKDDKKDKDKKDKKKKKDDDDDDKKKKKKKKK
List of places blurred out on Google Maps	K	DDKKDKDKDDKDDKDDKDKKDKKKKKKKKKKKKKKDKDKDKKKKDKDKDKDKKKDDKDKKDKKDDDKKKKKDDKK
List of cats with fraudulent diplomas	K	DDKKKDKKKKKKKKKKKKKKKKKDKKKKKKKKKKKKKKKKKKKKKKDKDKKKKKKKKKKKKKKDKKKKKKKKKK
Transreal number	K	DDDDDKKKKDKKDKKDDKKDKKDDDKKKDDKKDKDDKDDKKKKDKKKKDDDKKKDKDDKDDKKKKKKKDDKK
The Gore Effect	K	DDDDKDDKKDKKKDDDDKKKKKKKDKDKKDDDKKDDKDDDKDKDKKDDDDDKKKKKKKKKKKKKDKKDKKK
Fitzmas	K	DKDDKKKDDKDDKKKKKKKKKKKDKKDKKKDKKKKKKKKKKKKKKKKKKKKDKKKKKKKKKKKKKKKKKKK
Harry Potter and the Half-Blood Prince (Crystal Ball)	K	DKKDKKKKKKDDDKDKKDKKKKKKKKKKDKDKKKDDDKKKKKKKKDDDDDDDDDDKKKKKKKKKKKKKKKK
Allegations of Israeli apartheid	K	DKDKKDKKDKDDKDDDDDDDDDDDDDKDKKKKKDKKDDDKKDKDKKKKKDKKKKDKDDDKDKKKKKDDKK
Cloverfield (creature)	K	DDKKKDKKDDKDDDDKKKKDKDDDDKKDDKDKKKKKDKKKKKKKKKKKKKKKDKKKKKKKKKKKKKKKKK
Faye Turney	K	DKKKKDKKDDKKKKKKKKKKKDKKKKKKKKDKKKKKKKKKKKKKDKKKDDKKKDKKKKKKKKDKKKKKKK
Movement to impeach George W. Bush (2nd nomination)	K	DDKDKKKKKKDDKKKKKDKKKKKKKKKKKKKKKDKKKKKKKKKKKKKKKKKKKDDKKKKKKKKKKKKKKK
Harvey Jackson	K	DKDDDKDDDDKKDDKKDDKKDDDKDKDDKDDKDDDKKKKKKDDKDDKKDKDDDDDDDKKKKKKKKKKKK
The Bus Uncle	K	KDDKDKDKKKDDDKKKKKDKDDKKDKDKDKKKKKKKKKKKKKDKKKKKKKKKKKKKKKKKKKKKKKKKK
Harry Potter and the Deathly Hallows (film)	K	DDDKDKDKKDKKKKKKKKKDKKKKKKKDDDKKKKKKKKKKDKKKKKKKKKKKKKKKKKKKKKKKKKKKK
Angela Beesley (7th nomination)	K	DDDKKKDDKKKKKKKDDDKKKDKDDDDDKDDDKDDKDKDDDKKKKKKKDDDDDDKKDKDDKKDKDKK
List of ...For Dummies books	K	DKDDKDDDKKKDDKKDDDDDDDKDDDKDDDDDDDDDDDKDKDDKKKKDKKDKKDDKDDKDDKDDDDK
John Smeaton (baggage handler)	K	DDDDKKKDKKDDKKKKKKDKKKDKKKKKKKKKKKKDKKKKKKKKKDKKKKKKKKKKKKKKKKKKKKK
List of scientists opposing the mainstream scientific assessment of global warming (3rd nomination)	K	DDKKDKKDDKKDDDKDKDDKKDDKDDDDDDDKKDKDDDDDKKDKDKKKDKDDDDKKKKDKKDKKKK
Emily Sander	K	DKKDDDKKDDKKKDDKDDDKKKKDDKDKKKDDKKKKKKDDKDKKDKDDDKDKDKKDKDDDKDDKK
List of common misconceptions (2nd nomination)	K	DDKKKKKKKKDDKKDKKDDDKKDKDKKKKDKDDDKDDDDKKKDKDKDDDDDKKKDDDDDKKKKKD
2009 attacks on Indian students in Australia	K	DDDKKKKKKKKKKDDKKKDDKKKKKKKKKKKKKKKKKKKKKKDKKKKKKKKKDDKKKKKKKKKKK
2004 U.S. presidential election controversy and irregularities	K	DKKDKKKDKKKDDKKDKDKKKKKKKKKKDKKKKKKKKKKKDKKKKKKDDKKDDDKKKKKKKKKK
Anti-Iranianism	K	DKKDKDKDDDKDDDKKKKKDDDDDDDDKDKKKKKKKKDKKKDKKKKKKDDKDKKDKKKKDKK
2008 Chino Hills earthquake	K	KDKKDDKKKKKKKKDKKDKDDKKKDKKKKKKKDKDKKDKKDKDDKKKKDKKKKKKKDKKKKK
Shawn Hornbeck	K	DDKKDKKKKDKKKKDKKKDDKKKKKKKKKKDKKKKKKKKKKKKKKKKKKKKDKKKKKDKKKK
Barbara Schwarz (4th nomination)	K	DKDDKKDKDKDKKDDDKKKKDKKKDDKKKKKKKKKKKKDKKKKKKDKDKKKKKDDKKKKKDK
International response to the 2010 Polish Air Force Tu-154 crash	K	DDKDKKKKDDKKKKKDKKKKDDKKDKKKDDKKDDDKKDDDKKDDDKDKKKDKKKKKDDKDKK
2009 Richmond High School gang rape	K	DKDKDDKDDKDDKKDKKDKDKKDDKKKDKKDKKDKKKKKDDDKKKDDKKKKDKKKKDKKKK
James Kim	K	DKKKKKKKKKKKKKKKKKDKKDKKKKKKKKKDKKKKKKKKKKKKKKKKKKKKKKKKKDKKK
Lolcat	K	DDDDKDDKDDKKKKDKKKKKKDKDKKKKKKKKKKKKKKKDKDKKKKKKKKKKKKKKKKKKK
Saugeen Stripper 2	K	KKKDDKDKDDDDDDDDKDKDDDDDDDDKDDDDDDKDDKKDKDDKDKKDKKDDKKDKDDKK
Brendan Burke	K	DKKKKKKKKKKKKKKKKKKKKKKKKKKKKKKKKKKKDKKKKKKKKKKDKKKKKKKKKKKK
Eve Carson	K	DKDDDKKKKDKKDKDKDKKDKKKDDDKDKDDKDDKKKKKKKKKDKKDDKKKKDKKDKKK
Jennifer Strange	K	DDDKDKKKKKKDDKKDKKDKKKKDDKKKKKKKDKKKDKDKDKKKKKKDKKKKKKKKKKK
Sam Loxton with the Australian cricket team in England in 1948	K	DKKKDKKKKKKKKKKKKKKKKKKKKDKKKKKDKKKKKKDKKKKKKKKKKDKKKKKKKKKKKK
List of victims of the Columbine High School massacre	K	DDDKKKDKKKDKKKDDDDDDKKKKDKKKKKDKKDKKKKDKKDKKKDKKKDKDKKDKKK
Anonymous (group)	K	DKKKKKKKKKKDDKKKKKKKKKKKKKKKKKKKKKKKKKKKKDKKDKKKKKKDKDKKDK
Kept Man	K	KDKKDDDKDDDKKKDKKDDKKKKKDKKKKKKKKDKKKDKKDKDKKDKKDKKDKKDKKK
"Bartlett High School	 Bartlett	 Illinois"	K	DDDKDKDDDKKDKDDDKDDDKDDKDDKKKDDKKDDKDDKKKDKDDKKDDDDDDDKKKK
Apartheid (disambiguation)	K	DKKDKDDDKDKDDDDKDDDDDDDDDKDKKKKKDKKKDDDDKDDDKKKDDKKDKKDKK
Israeli terrorism	K	DKDKDKKKKDKKKKDKKKKDKDKKKDDDDDDDKDDKKDDKDDDKDDKDDDDDKKKKK
Earth (2nd nomination)	K	DDDKDKDDDKDDKKDDDKDKKKKKDDDKKDDDKDKKDKDKDKKDKDDKKKKDKDDKK
Stephen Colbert at the 2006 White House Correspondents' Association Dinner	K	DKDKDKKDKKKDKKDKKKKKDKKKKKKKKKKKKKKKKKKDDKKKKDKKKKDKKKKKK
Tribalwar	K	DKDKKKKKKKKKKKKKDKDKDDDKKKKDKDDKDDKKDKKKDDDKDDDDDKDKKKKKK
Annie Le	K	DKKKKDKKKDKKKKKKKKKKKKKKKKDDKKDKDKDKDDKKKKDKKKKKKKKKKKKDD
Israeli art student scam	K	DDDDKDKDDDDDKDDKDKDDKKDDDDKDKDDDKDDDDDDDDDDKDDKKKKKDDKKK
Robert Frost Middle School	K	DDDKKKKDDDKKKDDDDKKKDKKKKKKKKDDDKKDDDKKKKKKKKKKKDKKDKKDK
2009 New York City airplane scare	K	DKKKDDKDDKKDDKDDDKDKKKKDKKDKDDKKKDKKKKKKDDDDKKDDDKKKKDDD
"Barack Obama speech to joint session of Congress	 September 2009"	K	DKKKDKKKKKKKKKKKKKKDKKDKKKKKKKKKKKDKKKKKKKKKKKKKKKKKKKKK
Mariana Bridi da Costa	K	DDKKDKKKDKKKKKKKKKKKKKKDDKKKKKKKDKDKKKDKKDDKKKKKKKDDKKKK
Essjay controversy (4th nomination)	K	DDDKKDKKKKKKKKKKKKKKKDKKKKKKKKKKKKKKDKKKKKKKKKKKKKDKKKK
Stereotypes of Jews (2nd nomination)	K	DDKDDDKDDDDDDDKDDDKKKDKDDKKKDDKDDKDKDKDKDDDDKKDDKDDDKK
Rationales to impeach George W. Bush (2nd nomination)	K	DDDDDKKDDDDDKKKKDDDDKKDKDDDKDDDDKDDDDDKDDDKDDDDKKDDDKK
"Opinion polling for the United States presidential election	 2008"	K	DDKDKKDDKKKKKKDDKKKKKKKKKKKKKKDKKKKKDDKKKKKKDKKKKKKKKK
Climate change denial (4th nomination)	K	DDKKKKKDKKKKKKDKKDKKKKKKKDDDDKKKDDKKKKKKKKKKKKKKDKKDKK
Benoit family tragedy	K	DKKKKKKKKKKKKKKKKKKKKKKKKKKKKKKKKKKKKKKKKKKKDKDKKKKKK
Wikigroaning	K	DKKKKKKDKKKKKKKKKDDDDDDDKDKKKKKKKKDDKKKKKDKDKKDKKKKKK
Criticism of Judaism	K	DDDDDDDKKKKDDDDDDDKDDDDDDDKDDDDKKDDDKKKKDDKDDDDDDKKDK
George Alexander (US Army soldier)	K	DDDKDDKDKDKDKDDDDDDKKDKDDKKDDKDKDKDKKDDDDKKKKKKKKKKKK
Wasilla Assembly of God	K	DKDDDKDKDDDDDKKDDKKKKKDDDKDDKDKKDDKDDDDKKKKKKKKKKKKKK
List of similarities between Canada and New Zealand	K	DDDKDKDDDKKKKKDKDDDKKKKDDDKDDDDKDKKDDDDDDDDDKDDKKKKK
Neda (Iranian protester)	K	DKKKKKKKDKKKKKDKKDKKKKKKKKKKKKKKKKKKKKKKKKKKKKKKDKKK
Mostafa Tabatabainejad	K	DKKKKKKKKKKKKKKDKKKKDKKKKKKKKKDKKKKKDDKKKKKKDKKKKKKK
Prussian Blue (American duo)	K	DKKKKKKKDKDKKKKKKKKKKKKKKKKKKDKKKKKKKDKKKKKKKKKKKKKK
The Mushroom Kingdom	K	DKKKKDDDKDDDDDDDDDDKKDDKDDDDDDDDDDDDDDDDDDKKKKKKKKKK
Santorum (sexual slang)	K	DDDKKDDKKKKDKKDDKKKKKDDDDDKKKKKKKDKKKKKKDKKKKKDKKKKK
Jim Cramer's appearance on The Daily Show with Jon Stewart	K	DKKKKKKKKKDKKKDKKDKKKKKKKKKKKKKKKKKKKDKDKDKKKDKKKDDK
Allegations of French apartheid	K	DKDKDDKDDDDKKDKKKDKKKDDKKKKKKKDDDDDDKDDDDDKDDDKDKKKK
Neda Agha-Soltan	K	DKKKKKKKKKKKKKKKKKKDKKKKKKKKKKKKKKKKKKKKKKKKKKKKKKKK
Smurf Communism	K	DKKKKKDKKDKKDKKKDKKKKKKKKKKKKKKKKKKKKKKKDKDDKKKKKKKK
Allegations of Israeli apartheid (5th nomination)	K	KDKKKKKDKKKKKDKKDDDDDDDDDKDDKDDDKKKKDDDKKKDKKKDDDKD
Elonka Dunin (2nd nomination)	K	DKKKKKKDDDKKKKKDDKKDKKKKKKKKKKKKKKDKKKKKKKKKKKKKDKK
Allegations of state terrorism by the United States	K	DKKKDKKDKDDKDKKDDKDKKDKKKKKKKKKKDKKKKDKKDKDKKDKDDKK
List of school pranks	K	DDDDKKDDDDDDKKDKKKKDKDKDDDKKKDDDKDKDDKKKKKDDDKKDKKK
Jordan Middle School	K	KKDDDDDDDDKDKDDKDDKDDDDKKDKDDDDKKKKDKKKDKKKKKKDDDDK
Controlled demolition hypothesis for the collapse of the World Trade Center	K	DDKDKKKKKDDKDDKDKKDDKKKDKDDKDKKKKDKKKKKKDKKKDKKKKKK
"Sir William Arbuthnot	 2nd Baronet"	K	DKDDKKKKKKDDDKDDDDKDKDKDDKKDDDKKKDDKDKDKKKDKKKKKDKK
List of bow tie wearers (4th nomination)	K	DKDKDKKKKKKKKKKKKDKKKDDDDDKDDKKKDKKKDDDDKKDKKKDKKKDDKDK
Anti-Semitism in Poland	K	DKKKKDKDDDKDKKKKDKDDKKDKKKDDKDDKDKDDDDDDDKKK
2004 U.S. presidential election controversy	K	DKKKKKKKKKKKKKKKKKKKKKKKKKKKKKKKKKKKDKKKKK
List of fictional swords	K	DDDDDKDKKKKKDDKDDDKDDDDKDDDDDDDDKDDKKKK
List of ethnic stereotypes	K	DDDKDDDKDDKKKDKKDDDKDDDDDKDDDDKDKKDDK
Philip Sandifer	D	DDDKDDDKDDKDDDDDKDKDKKDDKDDDDKDDDKDDKDDKDDDKDKKDDDDDDDDKDKKKDDDKDDDDKDDDDDDDDDDDDDKKDDDKDDKDKDDKKDKDDDDKDDDDDDDKDDKKKKDDDDDDDDDDDDDDK
Eon8 (2nd nomination)	D	KKKKKDKKDDKDDDDKKKKKKDKDKKKDDKDDKKKKKDKDDKKKKKKKDDKKKKKDKKKKDKDDDKDDDDKDKDDKKKDKDDKDDDKKDDKKDKKKDKKKDDKKDDKDDDKDKDKKK
Allison Stokke (second nomination)	D	DDDKDKDKDDDKDKDKDKDDDDKKDDDKDDKDDKDDDKDKKDDDKKDKKDKDDDKKDKKKDDKDDDDKKKKKKKDKKDKDDDKDDKDDDKDKDDDDDDDDDDDKDDDKDDKKK
易方达蓝筹精选混合	D	DDKDDKDDKDKKDDKDKDDDKDKDDKDKKKDKKDDKDKDDDKDKKDKDKDKKKKDKDDKDKKKKDKDKKKDKKDDKKKDDDKKKDDKKDKDKKDDKDKDDK
Jocelyne Couture-Nowak	D	DKKKDKKKKKDKDKDDKDKKKKKDKDDDDDKDDKKKKKDKDDDDKKKDDKDKKDDDDDKDKDDDDDDDDKKDKKKKKKDDKDDKKKKDDDDKKK
Allegations of Chinese apartheid	D	DKKDDDKKKKKDDKDKDDKDDDDKDKDKDKKKKDDDKKDKKKKDDDKDKKKDDDDDDDDKDDKKKDDDDKKKDDKDDKDKDKKDDDKDKK
Eon8	D	DDKDDKDKDDDKKKDKKKKKKKDDDKKKDKKDKDKKKDDKKKDKDKDDKDKKDKDDDKKDKDDDDKDDKKDKKKKKKKKKKKKKK
Sam Blacketer controversy	D	DDDDKKDDDDKDDDDDDDKKDDKKKKKKKDDKDDDKDDKKKKKKDDDDDDDDDDDDKDDDDDDDDDDDDDKDDDKDKDDDDDD
List of deaths in Harry Potter and the Deathly Hallows	D	DDDDKKDDDDKDDDKKDDDDKDDDDDDDDDKKDKDKKKDKKDDKDDKKKKKDDKKKDKKKKKDDDKKKDDKKKKKKK
Possible consequences of Kosovo independence	D	DDDKDDKDKKKKKDKKDKKKDKDKKKDDDDDKKDKKKDDDDDDKKKDDDDDKKDDDKDDDDKDDDDKKKKKK
List of Louisiana Baptist University people (second nomination)	D	DKDKKDDKKKDDKDKDKDDDDDDDDDDDDDKKKKKDKKDKKKKDKKKKDDDKKKDDKDDKDDKDDDKKDDDK
Gay Nigger Association of America (18th nomination)	D	DKDDDKKDDDDKDKDKKDDDDKKDKDDKDDDDKDDDDKDKKKDKDDKDDDDDKKKKDKKKKDKDDDDKKK
Harry Potter and the Half-Blood Prince - Full Plot Summary	D	KKKDKKKKKKKKKKDKDKKKKKKKDKKDKKKKKKKKKKKKKDDDDDDDDDDDKKKKKKKKKKKKKKKK
World Wide Web War I	D	DDDKDDDDDDDKKDDDDKDDDKKKKDKDKDDKKDKKKDDDKKDDDDDDDDKDDDDDKDDDDDDKKKKK
Allegations of apartheid (fifth nomination)	D	DKKDDKDDDKKKKDDKKKDKDKDDDDKKDKDDDDKKKDKKDKDDDKKKKDKKDKKDDKDKDKDKDDK
Teleprompter usage by Barack Obama	D	DKDKDDKDDDKDKKDDDKDDDDDDDKDDDDDDKDDDDDDDKDDDDDKDDDKKKKDDKKKDDKKDDD
Tony Pierce (second nomination)	D	KKKDKDDKDDDDDDDDKDKDDDDKKKDDDDDKDKKDDKDDDKDKDDDDDDDDDDDDDDDDDDKK
Boxxy	D	DKKDDDDDKKKDKDDKKKKKDDKDKDKDDKKDKKKKKKKDDKKKKDKKDDKKKDDKDKDKDK
Adult-child sex (2nd nomination)	D	DKKDKKKKDKDKKDDDDDDKDDDDDDDDKKDKDKKKKDKKDKKKKKKDKDDDDDKDDDDDDKK
Rachel Uchitel	D	DKKDDKDKKKKKKDKDDDDDDDDDKKKDDDDKDDKDDDDDDKDDDKDDKDDKDKKDDKKDD
Star Trek: Enterprise alleged continuity problems (third nomination)	D	DDKDDKKDDDDKDDKKDDKDDDDDDDDDKDKDDDDDDDDDDDDDDKDKKKDDDDKDDDD
Sexuality of Robert Baden-Powell (4th nomination)	D	DKDDDKDDDDKDKDKKDDDDDKDDDKDDDDDDKDDDDKDDDDDDDDDKDKDDDKDDDK
Andy Stephenson	D	DDDDDDDDKDKDKDKDDDKDDKKKKKDKKKKDKDKKKDKDDKDKKDDDDKKKKKKKKKK
Bush Crimes Commission (2nd nomination)	D	DDDKKKDDKDKDDDKDDDDDKDKKKDKKKKKKKDDDDKDDKKKDKKDDKKDDKDDKK
Boy*d Upp	D	KDKDDDDDDDDKDKDDKKDKKKDKDDKKKDDKKKKKKKDKDDDDDDDDDDDKKKK
Denial of Soviet occupation	D	DDKDDDDDKKDDKKKKDKKKKKDDDDKKKKDKKKKKKDKKKKDDKDKKKDDKDKD
Waleed Shaalan	D	DDKDDDDDKKDDKDKDKKDKKDKDKDKKKDDKKKDKKKDDKKKDKDDKDKKK
J. Otis Ledbetter	D	DKDDDDKDKKKKDKKKKDKKKDDKKKKDKKKDKKKDKDDKDKDKDDKKDDD
Dead Playboy Playmates	D	DDDDDDDDDDDDDDKDDDDDDDKDKDDKDKKDKKDDDDDKDDDKDDKDKK
Sturmgrenadier	D	DDKDKKKKKKDDDDDKDDDDKDDDDDDDDDDDDDDDKDDDKDDDDDDDDD
Jaimee Grubbs	D	DDDDDKKDDKDDDKDDDDDDDDDKKDDDKKDDDKDDDDDDDDDDDDKDK
What Really Happened (2nd nomination)	D	DDDKDDKDKKDKDKDKKDKDDKDKKDDDKDDDDKDDDDKDDKDDDKKKK
The Game (game) (6th nomination)	D	DDDDDDDKKDDDDDDKKDKKDDKDKDKDKDDKDDDDKKDKKKKKDDDDD
Lauren Burk	D	DDDKKDDDDDDKDDDDDDDDKDDKDDDKDDKDDDDKDDKDKDDDKDKK
List of Jewish communists	D	DDDDDKDDDDDDDKDDDDDDDDDDDDDDDDDDDDDDKDDDDDDDDDDD
911 Eyewitness	D	DDDDDDDDDKKKKDDDDKKDKDKKKDDKDDKDKKKKKKKKKKKKKKKK
Natasha Collins	D	DKKKKKKDKDKKKKKKDDKKKKKDKKKKKKKKKKDDKKKKKKDDDKK
Contemporary persecution of non-Jews by Jews	D	DDDDDDDDDDDDDDKDDDDDDDDDDKDDDDDDDDDDDDDDDDKDDK
CAT1-X Hyperion Gundam series	D	DDKDDKDKDDDKKKDKKKKKDKKDKKKDKKDDKKKDKKKKKDKKKK
2009 Fox News – White House controversy	D	KDKKKKKDKKKKDDKKDDDKKDKKKKKKDDKDDDKDDKKKKDDDKK
List of songs about masturbation (5th nomination)	D	DDDKDDDDDDKDKDDDKKKDKKDKKDKDDDDDDKKDDKDKKDDKKK
Lori Klausutis (third nomination)	D	DDDDDDDKKDDDKKKKKDKDDKKDDDDDDDDDKDDDDKKDDKDDKD
Israel Defense Forces using human shields	D	DKDDDKDDDKDDKDDKDKDDDDDDKDDDKDDKDDDDKDDDKDDDK
Children of Michael Jackson	D	DDKDKKKDDKKDDKDKDKKKDDDKKDDDDDKDDDKKDKKKKDDDD
9-11: The Road to Tyranny (3rd nomination)	D	DKDDKDKDDDDDKDDDKDDDDDDDDKKDKDKDDDDDDKKDDKKDD
Second Wizarding War	D	DDDDDDKKDKDDDDDKKKKDDKKKKKKDKKDKKDKKKKKKKKKK
Ancient persecution of non-Jews by Jews	D	DDDDDDDDDDDDDDDDDKDKDDDDDKDDDDDKDDDDDDDDDDDK
LostCasts	D	DDDDKDKDKKDKKDKKKKKKDKDKDKKKKKKKKKKKKKKKKKKK
Gotem(speech)	D	DKDKDDDDDDDDDDDDDDDDDDDDDKDDDDDDDDKDDDDKKKKK
Zeitgeist the Movie	D	DDKKDDKDKDKKDDDKDKKKDKDDDKDDKKKKDKDDDKDKKKKK
Prime Number Shitting Bear	D	DKDDDKDKDKDKDDDKDDDDDDDDDDDDDDDDDDDDDDKKDDDD
Stardestroyer.net2	D	DKKDKKDDDKDDDDKKDKDDDKDDKKKDKKKDKDDDDDDDKKK
3055 (number)	D	DDDDDDDDDDDDDDDDKKKKKKDDDDDKDDDDDDDDDKDDDDD
Ginger Jolie	D	DKKDKDDKKKDKDDKKKDDDDDDKDDKDDKKKDKKDDDDKKKD
Interchanges on Ontario provincial highway 401	D	DKKKKDDDDKDDDKDDKDDDDKDDDDDDKKDKKDDDDDDKKDD
Bob Mcilvaine	D	DDKDDKKKKKDDDDDDDKKDDDDDKKDDDDKDDDDDDDDDKD
Soviet occupation denialism	D	DDKKDDKKKKDKKKDKKDKKKKDKKKKKDDDKKKDKDKKDDK
Wikipedia Watch (5th nomination)	D	DDDDDDDKKDKDKDDDDDDKKDKKKKKKKDKDDDDDDDKKDD
Misconceptions about Iran	D	DDDDKDDDKKDDDDDKKDKKDKKKDKDDKKKKDKDDDKKDDK
Jon Blake (broadcaster)	D	DDKKDDDDKKDDDKDKDDDDDDDDDKKDDDDDDDDDDDDKDD
Objective validity of astrology	D	DDKDKDDDDKDKKDDDDDDDDDDKDKKDDKDKDDDDDKKDDD
List of Playboy Playmates with D-cup or larger breasts	D	DDDDKDKDDDDDKDDDDDDDDDDDKDDDKKKDKKKKDDDKK
Noemi Letizia	D	DDDDDDDKDDKKKKDKKKDDKKKDDDDKKKDDDKKDDDDDD
Islamophobiaphobia	D	DDDKDDDDKKKKKDDKKDDDDKDDDKKDDDKDDKKDDDKKK
"Ashlee Simpson U.S. tour	 2005"	D	DDKDDKDDDDDDDDDKDDDDDDDDDKDDDDDDKDDKDDDDK
Ahad's Constant	D	DDDKDKKDKKKDKDKKKKKDDDDKKDDDDDDDDDDDDDKKK
List of men famous for being well endowed	D	DKDKDDDKDDKKDKKKDDDDDDDDDDDDDDDKDKDKDDKKD
List of massacres commited by Israeli forces	D	DDDDDDKDKDDDKDKDDDDDKDDKDDKDDDDDDDKDDDDDK
Views of Creationists and mainstream scientists compared	D	DKKDKKKKDDDDDDKKDKDDDDDDKDKKDDDDDDDDDDDD
Worst United States President in history	D	DDDDDDDDDDKDDDDDDDDDDDDDDDDDKDKKDDDKDDDK
James Combs	D	DDKDDDKDDKKDDKKKDDKKDDDKDDKKDDDKDDDDDDDD
Deadmines	D	DDKKDKDDKDDKDDDDDKDDKKKDDKKKDDKKKDDKKKKK
New Cold War	D	DDKDKDDKDKKDDDKKDKDDKDKDDDKKDKKDKKDKDDDK
Wikinfo (6th nomination)	D	DDKDKKKDDDKKDDDKKDKKKDKDDKDKKDDDDDDDKKKD
Norman Technologies	D	DDDKDDKDDKKDDKDDKKKDDDKKDDKDDDDDKDDDDKK
List of proven conspiracies (2nd nomination)	D	DDDDDKKDDDKDDDKDDDDKKDKDDDDDDDDKDDDKDDK
Sheree Silver (2nd nomination)	D	DKKDDDKKDDDDKDDDDDKDDDDDKKDKKDDKDKDKKDK
North America (Americas)	D	DDDKKKDKKDKKDDKDDDDDKKDDKDKKKKKKKDDKKKK
The Motley Moose	D	DKKKDDDDDDKDKDKKDDKKKDKDDDDDDDDDDDDDKK
Wikipedia Death Penalty	D	DDKDDDDDDKDDDDDDDDDDKDDDDKDDDDDDDKDDDD
StarCraft units and structures	D	DDDKDKKKKDDDKDDDDDDKDKDDDKKDKKDDDDKKDK
MyWikiBiz (third nomination)	D	DDDKDDDDDDDDKDKDKKDKDDDDDKDDDDDDKKDKKK
Fuck the South 2	D	DDDDDDDKDDDDDKDDDDDDDDDDDDDKKDDDDKDDDD
List of proper nouns containing an exclamation mark (second nomination)	D	DDKDDDDDKDDKDDDDDKDDDDDDDDDDDDDKDKDDDD
List of ethnic stereotypes 2	D	DDDDDDDDDKDKDKKKDDDDDDDDDDDDDDDKDKDKD
Jewish supremacism	D	DDKDKDDDKDDDDDDDDDDDDDDDDDDDDDDDDDDDD
Church of Reality (2nd nomination)	D	DDDDDDDKKKKKKKKKKKKKKKKKKDDDDKDDDDKKK
List of Jewish bankers	D	DDDDKDDDDDKDDDDDDDDKDDDKDDDKDKKKDKDDD
Fuck The Earth Day	D	DDDDDDDKKDDKDDDDDDDDDDDDDDDDDDDDDDDDK
Long Horse	D	DDDDDDDDDKKKKDDDDDDDDDDDKKDDDKKDDKKKK
Unusual Sex Acts	D	DDDDDKDDKDDDDKDKDDDDKDDDDDDDDDDKDDDDK
South Azerbaijan National Liberation Movement	D	DKDKKKDKDDKKDDDKKKKKKKDDDDDDDDDKDKDDD
Unguided evolution	D	DDDDDDDDKDKKDKDDKKDDKDDDDDDDDDDDDDDDD